_________
|   |     |
|_     _  |
| | | |   |
|    _   _|
| |   |   |
|  _   _  |
|   |     |
|  _ ___  |
|         |
 _________
